TEX = "countries/Texas.txt"
BAY = "countries/Bavaria.txt"
ALA = "countries/Alabama.txt"
BIA = "countries/Biafra.txt"
HON = "countries/Honduras.txt"
BRA = "countries/Federative Republic of Brazil.txt"
URG = "countries/Uruguay.txt"
PAR = "countries/Paraguay.txt"
ARG = "countries/Argentina.txt"
CHL = "countries/Chile.txt"
BOL = "countries/Bolivia.txt"
SDL = "countries/Sendero Luminoso.txt"
PRU = "countries/Peru.txt"
ECU = "countries/Ecuador.txt"
FRC = "countries/FARC.txt"
COL = "countries/Colombia.txt"
VEN = "countries/Venezuela.txt"
GUY = "countries/Guyana.txt"
SRM = "countries/Suriname.txt"
PAN = "countries/Panama.txt"
COS = "countries/Costa Rica.txt"
NIC = "countries/Nicaragua.txt"
ELS = "countries/El Salvador.txt"
EMR = "countries/La Paz Del Salvador Military Region.txt"
GUA = "countries/Guatemala.txt"
ZAP = "countries/Zapatistas.txt"
MEX = "countries/Mexico.txt"
USA = "countries/United States of America.txt"
CAN = "countries/Canada.txt"
CUB = "countries/Cuba.txt"
WIF = "countries/West Indies Federation.txt"
HAI = "countries/Haiti.txt"
DOM = "countries/Dominican Republic.txt"
BED = "countries/Benin-Edo.txt"
POR = "countries/Portuguese Republic.txt"
SPA = "countries/Kingdom of Spain.txt"
CAT = "countries/Republic of Catalonia.txt"
FRA = "countries/France.txt"
GER = "countries/Federal Republic of Germany.txt"
BEL = "countries/Belgium.txt"
HOL = "countries/Netherlands.txt"
LUX = "countries/Luxembourg.txt"
CZE = "countries/Czechoslovakia.txt"
AUS = "countries/Austria.txt"
HUN = "countries/Hungarian People's Republic.txt"
NGA = "countries/Federal Republic of Nigeria.txt"
AMB = "countries/Federal Republic of Ambazonia.txt"
BEN = "countries/Benin.txt"
TOG = "countries/Togo.txt"
CDI = "countries/Cote d'Ivoire.txt"
ULI = "countries/UNMIL.txt"
LUR = "countries/Liberians United for Reconciliation and Democracy.txt"
MFD = "countries/Movement for Democracy in Liberia.txt"
LBT = "countries/Republic of Liberia.txt"
GHA = "countries/Ghana.txt"
BKF = "countries/Burkina Faso.txt"
MLI = "countries/Mali.txt"
NGR = "countries/Niger.txt"
AZW = "countries/Azawad.txt"
TAS = "countries/Transhumanist American Society for the Singularity.txt"
FAR = "countries/Free American Republic.txt"
NTI = "countries/Northwest Territorial Imperative.txt"
RAS = "countries/Revolutionary American Society for Freedom and Socialism.txt" #Repurposed tag for CPUSA
AZT = "countries/Aztlán Republic.txt"
NRG = "countries/National Reclamation Government of the United States.txt"
BSD = "countries/Black Self-Defense Forces.txt" 
HAW = "countries/Kingdom of Hawaii.txt"
JAP = "countries/Empire of Japan.txt"
KOK = "countries/Kingdom of Korea.txt"
PLK = "countries/People's Liberation Army in Korea.txt"
PRC = "countries/People's Republic of China.txt"
PHI = "countries/Philippine Republic.txt"
IND = "countries/Republic of Indonesia.txt"
MLY = "countries/Republic of Malaysia.txt"
SOL = "countries/Republic of the Solomon Islands.txt"
SIE = "countries/Sierra Leone.txt"
LRC = "countries/Lagos Regional Command.txt"
FCT = "countries/Federal Capital Territory Command.txt"
KAI = "countries/Kainji National Park.txt"
BOK = "countries/GPSPJ-Boko Haram.txt"
KAN = "countries/Kano State Government.txt"
PLT = "countries/Plateau Boys Batallion.txt"
ISP = "countries/Israel-Palestine Union.txt"
ITA = "countries/Italy.txt"
FAJ = "countries/People's Democratic Republic of Algeria.txt"
ANG = "countries/People's Republic of Angola.txt"
OMA = "countries/Oman.txt"
KUW = "countries/Kuwait.txt"
SAU = "countries/Saudi Arabia.txt"
UAE = "countries/United Arab Emirates.txt"
INA = "countries/Republic of India.txt"
YEM = "countries/Arab Republic of Yemen.txt"
YE2 = "countries/Democratic Republic of Yemen.txt"
SYR = "countries/Arab Republic of Syria.txt"
JOR = "countries/Kingdom of Jordan.txt"
CYP = "countries/Republic of Cyprus.txt"
LEB = "countries/Republic of Lebanon.txt"
EGY = "countries/Arab Republic of Egypt.txt"
CYR = "countries/Cyrenaica.txt"
TRP = "countries/Republic of Tripolitania.txt"
SUD = "countries/Arab Republic of The Sudan.txt"
SSD = "countries/Republic of South Sudan.txt"
EAF = "countries/East African Federation.txt"
CAM = "countries/Cameroon.txt"
GUN = "countries/Republic of Guinea.txt"
GBS = "countries/Guinea-Bissau.txt"
TGM = "countries/The Gambia.txt"
SEN = "countries/Senegal.txt"
MRT = "countries/Mauritania.txt"
MOR = "countries/Kingdom of Morocco.txt"
EQG = "countries/Equatorial Guinea.txt"
GAB = "countries/Gabon.txt"
ENG = "countries/United Kingdom.txt"
DEN = "countries/Kingdom of Denmark.txt"
IRE = "countries/Republic of Ireland.txt"
NOR = "countries/Norway.txt"
SWE = "countries/Kingdom of Sweden.txt"
FIN = "countries/Republic of Finland.txt"
SMR = "countries/San Marino.txt"
BIH = "countries/Bosnia-Herzegovina.txt"
CRO = "countries/Croatia.txt"
SLV = "countries/Slovenia.txt"
SOV = "countries/Soviet Federation.txt"
GRO = "countries/Chechnya.txt"
ARM = "countries/Armenia.txt"
GEO = "countries/Georgia.txt"
SWI = "countries/Switzerland.txt"
TUN = "countries/Republic of Tunisia.txt"
CBR = "countries/People's Republic of Congo.txt"
ZAI = "countries/Republic of Zaire.txt"
ZAM = "countries/Republic of Zambia.txt"
BTS = "countries/Republic of Botswana.txt"
MLW = "countries/Republic of Malawi.txt"
KAT = "countries/State of Katanga.txt"
MZB = "countries/People's Republic of Mozambique.txt"
SAF = "countries/Republic of South Africa.txt"
SWZ = "countries/Kingdom of eSwatini.txt"
LST = "countries/Kingdom of Lesotho.txt"
TUR = "countries/Turkish Republic.txt"
NCP = "countries/Turkish Republic of Northern Cyprus.txt"
AWB = "countries/Zuid-Afrikaansche Republiek.txt"
EFF = "countries/Black Redemption Front.txt"
NAM = "countries/Namibia.txt"
BUR = "countries/Republic of the Union of Burma.txt"
SIA = "countries/Kingdom of Thailand.txt"
FIJ = "countries/Republic of Fiji.txt"
BNG = "countries/People's Republic of Bangladesh.txt"
SAM = "countries/Independent State of Samoa.txt"
BHA = "countries/Republic of India.txt"
VIE = "countries/Socialist Republic of Vietnam.txt"
LAO = "countries/People's Republic of Laos.txt"
SVI = "countries/Republic of Vietnam.txt"
KMP = "countries/Kingdom of Cambodia.txt"
RAD = "countries/Radio Silence.txt"
BIU = "countries/All-Biafran United Defense Committee.txt"
YOR = "countries/Republic of Yorubaland.txt"
WES = "countries/Republic of Westphalia.txt"
SDE = "countries/East African Forces in South Sudan.txt"
SIY = "countries/Sosyal Isanyat.txt"
BZK = "countries/Bozkürt Movement.txt"
BSR = "countries/Brazilian Sixth Republic.txt"
PDB = "countries/People's Democratic Republic of Brazil.txt"
CHP = "countries/Republic of Turkey.txt"
KUR = "countries/Kurdistan.txt"
PTK = "countries/People's Republic of Turkey.txt"
AST = "countries/Commonwealth of Australia.txt"
POL = "countries/Polish People's Republic.txt"
ALK = "countries/State of Alaska.txt"
SVK = "countries/Soviet Presence in Alaska.txt"
KOH = "countries/United States Navy in the Pacific.txt"
ATI = "countries/Confederation of Autonomous Zones.txt"
CSC = "countries/Republic of Cascadia.txt"
NWF = "countries/Northwest Aryan Front.txt"
USM = "countries/United States Emergency Military Command.txt"
CAL = "countries/State of California.txt"
SCI = "countries/Sea Org.txt"
DES = "countries/State of Deseret.txt"
AZB = "countries/Arizona Border Recon.txt"
CHC = "countries/Chicano Republic.txt"
SAZ = "countries/State of Arizona.txt"
SNM = "countries/State of New Mexico.txt"
FCO = "countries/Free Colorado Republic.txt"
LKT = "countries/Lakotah Republic.txt"
USP = "countries/American Republic.txt"
COR = "countries/Corn-Belt Republic.txt"
TPR = "countries/3-Percenter Movement.txt"
RST = "countries/Steel Belt Republic.txt"
MIC = "countries/Michigan Militia.txt"
SMI = "countries/State of Michigan.txt"
DIX = "countries/Dixie Republic.txt"
APP = "countries/Republic of Appalachia.txt"
BLK = "countries/Black Citizens' Union.txt"
NYL = "countries/New York Light Foot Militia.txt"
SFL = "countries/State of Florida.txt"
SFA = "countries/State of Florida.txt"
PUE = "countries/Republic of Puerto Rico and the Virgin Islands.txt"
PSA = "countries/Pacific States Administration.txt"
RCO = "countries/Rockies Command.txt"
GPR = "countries/Great Plain-Rockies Command.txt"
DEA = "countries/Denver Administration.txt"
SLA = "countries/State of Louisiana.txt"
SLI = "countries/State of Louisiana.txt"
GLA = "countries/Great Lakes Administration.txt"
OBC = "countries/Ohio Basin Command.txt"
SOH = "countries/State of Ohio.txt"
SOI = "countries/State of Ohio.txt"
DSC = "countries/Deep South Command.txt"
COV = "countries/Commonwealth of Virginia.txt"
CVA = "countries/Commonwealth of Virginia.txt"
SCA = "countries/State of South Carolina.txt"
SCL = "countries/State of South Carolina.txt"
IRN = "countries/Socialist Republic of Iran.txt"
UNS = "countries/United Nations in Somalia.txt"
MGD = "countries/Republic of Mogadishu.txt"
SOM = "countries/Emirate of Somalia.txt"
DJI = "countries/Republic of Djibouti.txt"
ETH = "countries/People's Democratic Republic of Ethiopia.txt"
ZIM = "countries/Zimbabwe-Rhodesia.txt"
MAG = "countries/Democratic Republic of Madagascar.txt"
COM = "countries/Union of the Comoros.txt"
SEY = "countries/Republic of Seychelles.txt"
SRL = "countries/Sri Lanka.txt"
MLD = "countries/Maldives.txt"
SNG = "countries/Republic of Singapore.txt"
AFG = "countries/Democratic Republic of Afghanistan.txt"
MLT = "countries/Republic of Malta.txt"
YUG = "countries/Socialist Federal Republic of Yugoslavia.txt"
ROM = "countries/Socialist Republic of Romania.txt"
BUL = "countries/People's Republic of Bulgaria.txt"
GRE = "countries/Democratic Republic of Greece.txt"
ALB = "countries/Socialist Republic of Albania.txt"
SGF = "countries/SGF.txt"
DDR = "countries/German Democratic Republic.txt"
QIE = "countries/Empire of Great Qing.txt"
ICE = "countries/Republic of Iceland.txt"
IRQ = "countries/Republic of Iraq.txt"
PAK = "countries/Islamic Republic of Pakistan.txt"
NEP = "countries/Federal Democratic Republic of Nepal.txt"
BHU = "countries/Kingdom of Bhutan.txt"
NZL = "countries/New Zealand.txt"
MON = "countries/People's Republic of Mongolia.txt"
NWG = "countries/Republic of New Guinea.txt"
MAU = "countries/Republic of Mauritius.txt"
CHD = "countries/Republic of Chad.txt"
LCH = "countries/Transitional Government of National Unity.txt"
AVK = "countries/Revolutionary Communist Party USA.txt"
NYP = "countries/New York Police Department.txt"
PRD = "countries/Proud Boys.txt"
CAR = "countries/Central African Republic.txt"
ADR = "countries/Principality of Andorra.txt"
MNC = "countries/Principality of Monaco.txt"
BRU = "countries/Kingdom of Brunei.txt"
KAC = "countries/Kachinland.txt"
KOK = "countries/Kokang Autonomous Zone.txt"
ZGM = "countries/Zogam Republic.txt"
ARK = "countries/Arakan Rohingya Salvation Army.txt"
ARA = "countries/State of Arakan.txt"
SWA = "countries/Socialist Republic of Wa.txt"
SHA = "countries/Federated Shan States.txt"
KAW = "countries/Kawthoolei Republic.txt"
ADF = "countries/Allied Democratic Forces.txt"
NCD = "countries/Allied Democratic Forces.txt"
MNZ = "countries/MONUZ.txt"
HKG = "countries/Crown Colony of Hong Kong.txt"
PGR = "countries/People's Republic of the Persian Gulf.txt"
ILE = "countries/People's Lebanese Republic.txt"
TRM = "countries/Turkmeneli Republic.txt"
ALQ = "countries/Al-Qaeda.txt"
IRA = "countries/Republic of Iraq.txt"
SIT = "countries/Libere Entropia Nuniana.txt"
TRS = "countries/Székler Republic.txt"
SIB = "countries/Siebenburger Republic.txt"
HEL = "countries/Kingdom of Greece.txt"
ERI = "countries/Republic of Eritrea.txt"
ADM = "countries/Dominion of Andamania.txt"
ODS = "countries/Independent State of Odisha.txt"
DRA = "countries/People's Republic of Dravidia Nadu.txt"
BMB = "countries/Bombay Republic.txt"
KHA = "countries/State of Khalistan.txt"
KTR = "countries/Kingdom of Travancore.txt"
ASM = "countries/Federated States of Assam.txt"
NAG = "countries/State of Nagaland.txt"
MNI = "countries/Manipur Republic.txt"
MIZ = "countries/State of Mizoram.txt"
NUE = "countries/Nuer White Army.txt"
LRA = "countries/Lord's Resistance Army.txt"
ARB = "countries/Arrow Boys Militia.txt"
DRZ = "countries/Druze State.txt"
SHL = "countries/People's Republic of Lebanon.txt"
SYL = "countries/Islamic Republic of Lebanon.txt"
YNB = "countries/People's Republic of Yanbian.txt"
ROC = "countries/National Republic of China.txt"
RCA = "countries/National Republican Army.txt"
KPD = "countries/Korean Democratic Republic.txt"
STF = "countries/United Republic of Sao Tomé and Fernando Po.txt"
BKS = "countries/Democratic Republic of Bakassi.txt"
UNH = "countries/United Nations Headquarters.txt"
RSB = "countries/Rustenburg Military Region.txt"
TIB = "countries/Democratic Republic of Tibet.txt"
SRW = "countries/Raj of Sarawak.txt"
XIN = "countries/Democratic Republic of Xinjiang.txt"
PGN = "countries/Independent State of Papua New Guinea.txt"
TIL = "countries/Republic of Timor-Leste.txt"
PRA = "countries/People's Democratic Republic of Ambazonia.txt"
MSK = "countries/Commonwealth of Miskito.txt"
AZR = "countries/United Republic of the Azores and Madeira.txt"
PHL = "countries/Joint Democratic Forces of the Philippines.txt"
DJE = "countries/Protectorate of Djerba.txt"
SBR = "countries/Siberia.txt"